#######################################
# Syntax Coloring Map For OneSheeld
#######################################

#######################################
# Datatypes (KEYWORD1)
#######################################
Accelerometer	KEYWORD1
Buzzer	KEYWORD1
Camera	KEYWORD1
Email	KEYWORD1
Facebook	KEYWORD1
FlashLight	KEYWORD1
Foursquare	KEYWORD1
GamePad	KEYWORD1
GPS	KEYWORD1
GravitySensor	KEYWORD1
GyroscopeSensor	KEYWORD1
Keypad	KEYWORD1
LCD	KEYWORD1
LED	KEYWORD1
LightSensor	KEYWORD1
Magnetometer	KEYWORD1
Mic	KEYWORD1
MusicPlayer	KEYWORD1
Notification	KEYWORD1
OneSheeld	KEYWORD1
OrientationSensor	KEYWORD1
Phone	KEYWORD1
PressureSensor	KEYWORD1
ProximitySensor	KEYWORD1
PushButton	KEYWORD1
SevenSegment	KEYWORD1
Skype	KEYWORD1
Slider	KEYWORD1
SMS	KEYWORD1
TemperatureSensor	KEYWORD1
ToggleButton	KEYWORD1
Twitter	KEYWORD1
#######################################
# Methods and Functions (KEYWORD2)
#######################################
getX	KEYWORD2
getY	KEYWORD2
getZ	KEYWORD2
buzzOn	KEYWORD2
buzzOff	KEYWORD2
begin	KEYWORD2
capture	KEYWORD2
setFlash	KEYWORD2
send	KEYWORD2
updateStatus	KEYWORD2
setLow	KEYWORD2
setHigh	KEYWORD2
setValue	KEYWORD2
checkIn	KEYWORD2
isUpPressed	KEYWORD2
isDownPressed	KEYWORD2
isLeftPressed	KEYWORD2
isRightPressed	KEYWORD2
isAPressed	KEYWORD2
isBPressed	KEYWORD2
isCPressed	KEYWORD2
isDPressed	KEYWORD2
getLat	KEYWORD2
getLon	KEYOWRD2
isLat	KEYWORD2
isLon	KEYWORD2
init	KEYWORD2
getRow	KEYWORD2
getCol	KEYWROD2
setOnButtonChange	KEYWORD2
clear	KEYWORD2
home	KEYWORD2
noDisplay	KEYWORD2
display	KEYWORD2
noBlink	KEYWORD2
blink	KEYWORD2
noCursor	KEYWORD2
cursor	KEYWORD2
scrollDisplayLeft	KEYWORD2
scrollDisplayRight	KEYWORD2
leftToRight	KEYWORD2
rightToLeft	KEYWORD2
autoScroll	KEYWORD2
noAutoScroll	KEYWORD2
createChar	KEYWORD2
setCursor	KEYWORD2
write	KEYWORD2
print	KEYWORD2
getValue	KEYWORD2
stop	KEYWORD2
play	KEYWORD2
pause	KEYWORD2
previous	KEYWORD2
next	KEYWORD2
seekForward	KEYWORD2
seekBackward	KEYWORD2
notifyPhone	KEYWORD2
call	KEYWORD2
getPressure	KEYWORD2
getProx	KEYWORD2
setNumber	KEYWORD2
videoCall	KEYWORD2
message	KEYWORD2
getDegree	KEYWORD2
sendDirectMessage	KEYWORD2
getLattitude	KEYWORD2
getLongitude	KEYWORD2
isInRange	KEYWORD2
getDistance	KEYWORD2
radian	KEYWORD2